WWWWWWWWWWWWWWWWWWWWWWWWWWWWWWW
W     W     W       W         W
W   WWW     WW     WW         W
W   W    W   WW            WWWW
W   W    W   WW        WW     W
W   W   WW    WW  WWWWWW WWWWWW
W  WW   WW    W       W W     W
W       W             W W  WWWW
W       W             W W  WWWW
W       W             W W  WWWW
WWWWWWWWWWWWWWWWWWWWWWWWWWWWWWW